10 12
##########
#........#
#........#
#...###..#
#...#....#
#...#G...#
#...#....#
#...###..#
#........#
#........#
#S.......#
##########